11111111111
1PC00000001
100E0000001
10000000001
10000000001
11111111111
