11111111111
1P0E00C0001
10001100001
10000000001
11111111111
