11111111111
1PC000000E0000001
10000000001
10000000001
11111111111
