11111111111
100P00E0011
10001100001
1C000000001
11111111111