1111111111
111111P111
1111110111
1E00000101
1111C11101
1010000001
10100011M1
1111111111