1111111111111111
1P0C000000000001
1000000000000001
10000000E0000001
1000000000000001
1000000000000001
1111111111111111
