1111111111111
111111P110001
1000000110001
1E00000100001
1111C11100001
10100CCCCC001
1010001110001
1111111111111