11111111111111111111111
1C00P0000000CC000000001
10001000010001000010001
10001000010001000010001
11111111000001000010001
10001000010001000010001
10000CCC010011000010001
100010000101000C0010E01
10001000010001000010001
11111111111111111111111