1111111111
1000000001
10P0000101
1011011101
1111000111
1010000C01
1010E01101
1111111111