1111111111
1111011101
1C11001111
1000100E11
1110P01101
11111111111